------------------------------------------------------------------------------------------------------------------------------------------------------
|            |                                                                                                                                       |
|------      x                                                                                                                                       |
|                                                                                                                                                    |
|---     x                                                                                                                                           |
|  |     x                                                                                                                                           |
|  |--                                                                                                                                               |
|                                                                                                                                                    |
|                                                                                                                                                    |
|                                                                                                                                                    |
|                                                                                                                                                    |
|                                                                                                                                                    |
|                                                                                                                                                    |
|                                                                                                                                                    |
|                                                                                                                                                    |
|                                                                                                                                                    |
|                                                                                                                                                    |
|                                                                                                                                                    |
|                                                                                                                                                    |
|                                                                                                                                                    |
|                                                                                                                                                    |
|                                                                                                                                                    |
|                                                                                                                                                    |
|                                                                                                                                                    |
|                                                                                                                                                    |
|                                                                                                                                                    |
|                                                                                                                                                    |
|                                                                                                                                                    |
|                                                                                                                                                    |
|                                                                                                                                                    |
|                                                                                                                                                    |
|                                                                                                                                                    |
|                                                                                                                                                    |
|                                                                                                                                                    |
|                                                                                                                                                    |
|                                                                                                                                                    |
|                                                                                                                                                    |
|                                                                                                                                                    |
|                                                                                                                                                    |
|                                                                                                                                                    |
|                                                                                                                                                    |
|                                                                                                                                                    |
|                                                                                                                                                    |
|                                                                                                                                                    |
|                                                                                                                                                    |
|                                                                                                                                                    |
|                                                                                                                                                    |
|                                                                                                                                                    |
|                                                                                                                                                    |
------------------------------------------------------------------------------------------------------------------------------------------------------
